6 9
XXXXXXXXX
X H     X
X       X
XXX     X
XWT M  QX
XXXXXXXXX