7 9
XXXXXXXXX
XH      X
X    XXXX
X  W    X
XXX     X
XWTM   QX
XXXXXXXXX