9 9
XXXXXXXXX
X   W  HX
X TTTTT X
X TT  T X
X TTMTT X
X TTTTT X
X TTTTT X
X      QX
XXXXXXXXX