21 21
XXXXXXXXXXXXXXXXXXXXX
XHW           T     X
X XTXTTTXTX X X TTT X
X     X   W T W X   X
XTWXW X X XWW X T W X
X   T   X   X   T T X
XTX TXXWTXT X TWW X X
X   W     X T   W T X
X X T X WTT XXXXX T X
X T   W X   X     T X
X TTXWXTW WTT WXWWW X
X     W   W   W     X
X TWT T TWW XTT XWWTX
X   T W  M  X W W   X
XXXTT TXXXWWT W W WTX
X       T       X   X
X XTXTXTW XTTTWXTWT X
X X     T X         X
X W WTW X T WTXXWXX X
X     W     T      QX
XXXXXXXXXXXXXXXXXXXXX